...###.....
..##.#.####
.##..###..#
##........#
#...@......
###..###..#
..#..#....#
.##.##.#.##
.#......##.
.#.....##..
.#######...
