440000111111220000000000
440000111111220000000000
000011110011001111111100
000011110011001111111100
001111000011111100001100
001111000011111100001100
111100000044000000221100
111100000044000000221100
11000000T011000000000011
110000000011000000000011
111111000011113300001100
111111000011113300001100
000011000011t00000001100
000011000011000000001100
001111001111001111001111
001111001111001111001111
001100000000000011110000
001100000000000011110000
001100000000001111000000
001100000000001111000000
001111111111111100003300
001111111111111100003300
000000000000000000000000
000000000000000000000000
