442222333333333333222244
442222333333333333222244
220000000000000000000022
220000000000000000000022
220044111111111111440022
220044111111111111440022
330011000000000000110033
330011000000000000110033
330011004411114400110033
330011004411114400110033
330011001100001100110033
3300110011T0001100110033
330011001100001100110033
330011001100001100110033
330011004411001100110033
330011004411001100110033
330011000000001100110033
330011000000001100110033
220044111111114400110022
220044111111114400110022
22000000000000000011t022
220000000000000000110022
442222333333333333222244
442222333333333333222244