434343434343434343434343
343434343434343434343434
430000000000000000000043
340000000000000000000034
430022222222222222220043
340022222222222222220034
430022000000000000220043
340022000000000000220034
430000002200002200000043
3400T0002200002200000034
430000002200002200000043
340022002200002200220034
430022002200002200220043
340000002200002200000034
430000002200002200t00043
340000002200002200000034
430022000000000000220043
340022000000000000220034
430022222222222222220043
340022222222222222220034
430000000000000000000043
340000000000000000000034
434343434343434343434343
343434343434343434343434