22222222222
20000000002
21100111002
21000000022
2000T100102
21100111002
20100100002
211011t1102
21000000112
21000001102
22222222222