222222222222222222222222
222222222222222222222222
222222222222222222222222
222222222222222222222222
222200000000000000000000
222200000000000000000000
22220000000t000000000000
222200000000000000000000
222211111111000000001111
222211111111000000001111
222211111111000000001111
222211111111000000001111
222211110000000000000000
222211110000000000000000
222211110000000000000000
222211110000000000000000
2222000000000000T0001111
222200000000000000001111
222200000000000000001111
222200000000000000001111
222211111111000000001111
222211111111000000001111
222211111111000000001111
222211111111000000001111
