222222222222222222222222
222222222222222222222222
220000000000000000000022
220000000000000000000022
220000000000000000000022
220000000000000000000022
220000000000000000000022
220000000000000000000022
22000000T000000000000022
220000000000000000000022
220000000000000000000022
220000000000000000000022
220000000000000000000022
220000000000000000000022
2200000000t0000000000022
220000000000000000000022
220000000000000000000022
220000000000000000000022
220000000000000000000022
220000000000000000000022
220000000000000000000022
220000000000000000000022
222222222222222222222222
222222222222222222222222
