22222222222
20000000002
20000000002
20000000002
2000T000002
20000000002
20000000002
20000t00002
20000000002
20000000002
22222222222