22222222222
21111111112
20000000002
20000000002
2000T0000t2
20000000002
20000000002
20000000002
20000000002
21111111112
22222222222