222222222222222222222222
222222222222222222222222
221111111111111111111122
221111111111111111111122
220000000000000000000022
220000000000000000000022
220000000000000000000022
220000000000000000000022
22000000T00000000000t022
220000000000000000000022
220000000000000000000022
220000000000000000000022
220000000000000000000022
220000000000000000000022
220000000000000000000022
220000000000000000000022
220000000000000000000022
220000000000000000000022
220000000000000000000022
220000000000000000000022
221111111111111111111122
221111111111111111111122
222222222222222222222222
222222222222222222222222
