002222222222222222222200
002222222222222222222200
221111111111111111111122
221111111111111111111122
220000000011110000000022
220000000011110000000022
220000000011110000000022
220000000011110000000022
22000000T01111000000t022
220000000011110000000022
220000000011110000000022
220000000011110000000022
220000000011110000000022
220000000011110000000022
220000000011110000000022
220000000011110000000022
220000000011110000000022
220000000011110000000022
220000000011110000000022
220000000011110000000022
221111111111111111111122
221111111111111111111122
002222222222222222222200
002222222222222222222200
