02222222220
21111111112
20000100002
20000100002
2000T1000t2
20000100002
20000100002
20000100002
20000100002
21111111112
02222222220