222222222222222222222222
244000000444444444000332
244000000444444444400332
2000T0000110004444444002
200000000111111044444402
200000000111111004444402
200000000000033004444402
200000000000033000000002
233334442222211000000002
233334442222211000000002
200000000000033000000002
200000000000033000000002
200000000000033000000002
200000000000033000000002
200000000000033000000002
204444400000033000000002
204444441111122444411112
204444441111122444411112
233444444000000000000002
233344444000000000000002
23333440000000000000t002
243333400000000000000002
244333300000000000000002
222222222222222222222222