222222222222222222222222
244000000440000000000332
244000000440000000000332
2000T0000110000000000002
200000000111111000000002
200000000111111000000002
200000000000033000000002
200000000000033000000002
233332211111111000000002
233332211111111000000002
200000000000022000000002
200000000000022000000002
200000000000022000000002
200000000000022000000002
200001111111122444411112
200001111111122444411112
200001100000000000000002
20000110000000000000t002
200004400000000000000002
200004400000000000000002
222222222222222222222222