222222222222222222222222
222222222222222222222222
223300000004400000003322
223300000004400000003322
22000T000001100000000022
220000000001100000000022
220000000001100000000022
220000000001100000000022
220000000001100000000022
220000000003300000000022
220000000003300000000022
221144411333333114441122
221144411333333114441122
220000000003300000000022
220000000003300000000022
220000000001100000000022
220000000001100000000022
220000000001100000000022
22000000000110000t000022
220000000001100000000022
223300000004400000003322
223300000004400000003322
222222222222222222222222
222222222222222222222222