333333333333333333333333
333333333333333333333333
33000000000T000000000033
330000000000000000000033
330000000000000000000033
331122222211111110001133
331122222211111110001133
330000000000000000000033
330000000000000000000033
330000000000000000000033
330000000000000000000033
331111111222222111111133
331111111222222111111133
330000000000000000000033
330000000000000000000033
330000000000000000000033
330000000000000000000033
331110001111112222221133
331110001111112222221133
330000000000000000000033
33000000000t000000000033
330000000000000000000033
333333333333333333333333
333333333333333333333333