442222222222222222222244
442222222222222222222244
220000000000000000000022
220000000000000000000022
220000T00000000022000022
220000000000000022000022
220000000000000022000022
220000000022222222000022
220000000022222222000022
220000000022000000000022
220000000022000000000022
220022222222000000000022
220022222222000000000022
220000000022000000000022
220000000022000000000022
220000000022222222000022
220000000022222222000022
220000000000000022000022
220000t00000000022000022
220000000000000022000022
220000000000000000000022
220000000000000000000022
442222222222222222222244
442222222222222222222244